10
......................................~~~~...................
.......#####...........................~~~~..................
.......#...#...........................-------...............
.......#...#.................................................
.......##.##...........................-------...............
.........................................~~~~................
.........................................~~~~................
........................................~~~~.................
.......................................~~~~..................
.....................................~~~~....................